King Crimson - 21st Century Schizoid Man
Pink Floyd - Interstellar Overdrive
the Jimi Hendrix Experience - 1983
Cream - Sunshine Of Your Love
The pretty things - S.F. Sorrow is born
Ultimate Spinach - Jazz Thing
The West Coast Pop Art Experimental Band - Shifting Sands
The doors - End of the Night
The Velvet Underground - Heroin
Led Zeppelin - Dazed and Confused
nu exista acest gen inca!
nu exista acest gen inca!
nu exista acest gen inca!
Silver Apples - Lovefingers
White Noise - Your Hidden Dreams
The Beatles - Eleanor Rigby
Love - Andmoreagain
The Beach Boys -  God only knows
The Kinks - Do you remember Walter
The Zombies - Care of Cell 44
The Monkees - The Door Into Summer
The Byrds - Renaissance Fair
Small Faces - Song of a Baker
America - Rainy Day
Jefferson Airplane - Today
Miles Davis - Shhh  Peaceful
John Coltrane -Part II - Resolution
Mingus - Solo Dancer, Stop! Look! And Listen, Sinner Jim Whitney
Frank Zappa - Peaches En Regalia
Leonard Cohen - Master Song
Muddy Waters - Mean Disposition
Pink Floyd- Dogs
David Bowie - Oh! You pretty things
Black Sabbath -Solitude
Yes - Close to the edge
Can - Future Days
Blue Oyster Cult - Astronomy
Gentle Giant - Proclamation
Van der Graaf Generator - Killer
T. Rex - Cosmic Dancer
Lou Reed - Perfect Day
nu exista acest gen inca!
nu exista acest gen inca!
Joy Division - Disorder
Television - Marquee Moon
The Stooges - Down on the Street
The Clash - The Guns of Brixton
Gang of Four - Damaged Goods
Wire - Mannequin
Patti Smith - Gloria
The Modern Lovers - Astral Plane
Devo - Uncontrollable Urge
XTC - When You're Near Me I Have Difficulty
Mort Garson - Symphony for a Spider Plant
Herbie Hancock - Hidden Shadows
Kraftwerk - Das Model
Eno - I'll Come Running
David Bowie - Speed of Life
Nick Drake - Place to Be
Jethro Tull - Aqualung
Comus - Diana
Weather Report - Black market
Lynyrd Skynyrd - Free Bird
Paul McCartney & Wings - Jet
Steely Dan - Do It Again
The Kinks - Lola
Blondie - Heart of Glass
Sparks - Thank God It's Not Christmas
The Cure - Disintegration
The Smiths - I Know It's Over
Joy Division - A Means to an End
Dead Kennedys - Trust Your Mechanic
Black Flag - Beat My Head Against the Wall
This Heat - Paper Hats
Minutemen - Anxious Mo-Fo
Hüsker Dü - Something I Learned Today
The Sound - I can't escape myself
Bad Brains - Sailin' On
Talking Heads - Born Under Punches
Pixies - Debaser
Sonic Youth - Teen Age Riot 
King Crimson - Matte kudasai
Rush - Limelight
Dinosaur Jr - Sludgefeast
Siouxsie and The Banshees - Spellbound
Big Black - Kerosene
David Bowie -Scary Monsters (And Super Creeps)
Bauhaus - St. Vitus Dance
Prince - Purple Rain
Cocteau Twins - Aloysius
Michael Jackson - Wanna Be Startin' Somethin'
R.E.M. - Radio Free Europe
Peter Gabriel - And Through the Wire
New Order - Age of Consent
Tears for Fears - Mothers Talk
Kate Bush - Cloudbusting
Depeche Mode - A Question of Time
A-ha - Train of Thought
link uri pop si poze